1111111111
1000C00001
111010C001
1P00010001
101110E001
1111111111