1111111111111111111111111111111111
100000010C00000C0000000000110000E1
1011111010000000000000000111110001
10000C0010001111000000000111100001
1000000010000000000111111000000001
1000011110000C00C00000000100C00001
100P00000C000000011111111111000001
100001111000111111111110000C000001
1000000000000000000000000000000001
1111111111111111111111111111111111