11111111
10E00001
10000C01
100C0001
11111111