1111111111
100P000001
1000000001
10E0001111
10000100C1
1111111111