111110011
100PEC001
011111110
111111111